BL BL WL WL WL WL WL BL WL WL WL WL WL BL BL
BL BL WL BL BL BL WL WL WL BL BL BL WL BL BL
BL BL WL BL CH BL WL PL WL BL CH BL WL BL BL
WL WL WL WL WL DR WL DP WL DB WL WL WL WL WL
WL BL KR BL DB BL BL BL BL BL DR BL KB BL WL
WL BL CH BL WL KB BL BL BL KR WL BL CH BL WL
WL BL BL BL WL CH BL ST BL CH WL BL BL BL WL
WL BL CH BL WL BL BL BL BL BL WL BL CH BL WL